11111111111111111111111
1CCCCC1CCCCCCCCC1CCCCC1
1@111C1C1111111C1C111@1
1CCCCCCCCCCCCCCCCCCCCC1
111C1C1111C1C1111C1C111
111C1C1111C1C1111C1C111
100C1CCCCCC1CCCCCC1C001
111C111101111101111C111
111C0000000G0000000C111
111C1110111E1110111C111
111C10001G0G0G10001C111
111C101011111110101C111
100C001000000000100C001
111C111111010111111C111
111CCCCC0001000CCCCC111
111C111C1111111C111C111
1CCCCCCCCCCPCCCCCCCCCC1
1C111C1111C1C1111C111C1
1C111C1CCCC1CCCC1C111C1
1@111C1C1111111C1C111@1
1CCCCCCCCCCCCCCCCCCCCC1
11111111111111111111111
