1111111111111111111111111
1111111CCCCCCCCCCC1111111
1111111@1C11111C1@1111111
1111111C1CCC1CCC1C1111111
1111111C111C1C111C1111111
1000CCCC1CCCCCCC1CCCC0001
1111C1111C11111C1111C1111
1111C1111C11111C1111C1111
11CCCCCC1CCC1CCC1CCCCCC11
11C1111C111C1C111C1111C11
11CCC11CCCCCGCCCCC11CCC11
1111C111C111E111C111C1111
10C1CCCCC1G0G0G1CCCCC1C01
11CCC111C1111111C111CCC11
11C1C1CCCCCCPCCCCCC1C1C11
10C1C1C11111111111C1C1C01
1111C1CCCCCC1CCCCCC1C1111
1111C111111C1C111111C1111
11CCCCCCCCCCCCCCCCCCCCC11
11C1C111111111111111C1C11
11@CC111111111111111CC@11
1111111111111111111111111
