11111111111111111111111
1CCCCCCCCCC1CCCCCCCCCC1
1C111C1111C1C1111C111C1
1@111C1111C1C1111C111@1
1CCCCCCCCCCCCCCCCCCCCC1
1C111C1C1111111C1C111C1
1CCCCC1CCCC1CCCC1CCCCC1
11111C11110101111C11111
11111C10000G00001C11111
11111C10111E11101C11111
10000C001G0G0G100C00001
11111C10111111101C11111
11111C10000000001C11111
11111C10111111101C11111
1CCCCCCCCCC1CCCCCCCCCC1
1C111C1111C1C1111C111C1
1@CC1CCCCCCPCCCCCC1CC@1
111C1C1C1111111C1C1C111
1CCCCC1CCCC1CCCC1CCCCC1
1C11111111C1C11111111C1
1CCCCCCCCCCCCCCCCCCCCC1
11111111111111111111111
