1111111111111111111111111111111111111111111111
1CCCCCCCCCCCCCCCCCCCCCCCCCCCCCCCCCCCCCCCCCCCC1
1@11C1111111C11111111111C1111111011C1111C111@1
1CCCC1111111CCCCCCCCCCCCC000G000011CCCCCCCCCC1
1111C11CCCCCC11111C111110111E111011C11111C1111
1111C11C1111C11111C1111101G0G0G1011C11111C1111
1000C11CC@11C11111C1111101111111011C11111C0001
1111C1111111C11111C1111100000000011C11CCCC1111
1111C1111111C11111C1111101111111011C11111C1111
1CCCCCCCCCCCCCCCCCCCCCCCC1111111CCCCCCCCCCCCC1
1C111C11111111C1C1111111CCC111CCC111111C1111C1
1@CCCCCCCCCCCCC1CCCCCCCCC1CCPCC1CCCCCCCCCCCC@1
1111111111111111111111111111111111111111111111
