1111111111111111111111111
11CCCCCCCC1CCC1CCCCCCCC11
11@111111C1C1C1C111111@11
11C1CCCCCCCC1CCCCCCCC1C11
11CCCC1C111C1C111C1CCCC11
11111C1C111C1C111C1C11111
11111C1CCCCCCCCCCC1C11111
10CCCC111C11111C111CCCC01
11C11CCCCCCCGCCCCCCC11C11
11C111C1C111E111C1C111C11
11CCCCC1C1G0G0G1C1CCCCC11
11C1C111C1111111C111C1C11
11C1CCCCCCCCCCCCCCCCC1C11
11C11C11111C1C11111C11C11
11CCCCC1CCCC1CCCC1CCCCC11
1111C1C1C1111111C1C1C1111
11@CC1CCCCCCPCCCCCC1CC@11
11C111C1111C1C1111C111C11
11CCCCC1CCCC1CCCC1CCCCC11
11C111C1C1111111C1C111C11
11CCCCC1CCCCCCCCC1CCCCC11
1111111111111111111111111
