11111111111111111111111
11111111111111111111111
1000011CCCCCCCCC1100001
1111011C1111111C1101111
1111011C1111111C1101111
1@CCCCCCCCC1CCCCCCCCC@1
1C111111C1C1C1C111111C1
1C1CCCCCC1C1C1CCCCCC1C1
1C1C111011CCC110111C1C1
1CCCCC10111111101CCCCC1
11111C10000G00001C11111
11111C10111E11101C11111
1CCCCC001G0G0G100CCCCC1
1C111C10111111101C111C1
1CCC1C10000000001C1CCC1
111C1C11101110111C1C111
111CCCCCCC111CCCCCCC111
111C11111C111C11111C111
100CCC11CCCPCCC11CCC001
111C1C11C11111C11C1C111
111C1C11C11111C11C1C111
1@CC1CCCCCC1CCCCCC1CC@1
1C111C1111C1C1111C111C1
1CCCCCCCCCCCCCCCCCCCCC1
11111111111111111111111
