111111111111
1GCCC1CCCPE1
1C11C1C11C11
1C1CCCCC1C11
1CCC111CCC11
1C1CCCCC1C11
1C11C1C11C11
1CCCC1CCCC11
111111111111
